25 25

#########################
#.......................#
#.......................#
#.......................#
#.......................#
#.......................#
#.......................#
#.......................#
#.......................#
#.......................#
#.......................#
########........#########
#.......................#
#.......................#
#.......................#
#.......................#
#.......................#
#.......................#
#.......................#
#.......................#
#.......................#
#.......................#
#.......................#
#.......................#
#########################
